Athletic Club
Gorka Iraizoz	 Portero
Gaizka Toquero	 Delantero
Jon Aurtenetxe	 Defensa
Fernando Amorebieta	 Defensa
Mikel San José	 Defensa
Ander Iturraspe	 Centrocampista
Fernando Llorente	 Delantero
Óscar De Marcos	 Centrocampista
Ibai Gómez	 Delantero
Raúl Fernández-Cavada Mateos	 Portero
Markel Susaeta	 Centrocampista
Andoni Iraola	 Defensa
Ismael López Blanco	 Delantero
Iñigo Pérez	 Centrocampista
Carlos Gurpegi	 Centrocampista
Iker Muniain	 Delantero
Aritz Aduriz	 Delantero
Ander Herrera Agüera	 Centrocampista
Xabier Castillo	 Defensa
Borja Ekiza	 Defensa
Igor Martínez Caseras	 Centrocampista
Iñigo Ruiz de Galarreta Exteberria	 Centrocampista
Jonás Ramalho	 Defensa
Aymeric Laporte	 Defensa
Fútbol Club Barcelona
Víctor Valdés	Portero
Daniel Alves	Defensa
Gerard Piqué	Defensa
Francesc Fábregas	Centrocampista
Carles Puyol	Defensa
Xavi Hernández	Centrocampista
David Villa	Delantero
Andrés Iniesta	Centrocampista
Alexis Sánchez	Delantero
Lionel Messi	Delantero
Thiago Alcántara do Nascimiento	Centrocampista
Jonathan dos Santos	Centrocampista
Javier Mascherano	Defensa
Marc Bartra	Defensa
Sergio Busquets	Centrocampista
Pedro Rodríguez Ledesma	Delantero
Jordi Alba	Defensa
Martín Montoya	Defensa
Adriano Correia	Defensa
Alexandre Song	Centrocampista
Cristian Tello	Delantero
RCD Espanyol
Cristian Álvarez	 Portero
Raúl Rodríguez	 Defensa
Víctor Sánchez Mata	 Centrocampista
Sergio Tejera	 Centrocampista
Juan Forlín	 Defensa
Raúl Baena	 Centrocampista
Christian Stuani	 Delantero
Álvaro Vázquez García	 Delantero
Sergio García de la Fuente	 Delantero
Joan Verdú	 Centrocampista
Rui Pedro Da Rocha Fonte	 Delantero
Samuele Longo	 Delantero
Francisco Casilla Cortés	 Portero
Héctor Moreno	 Defensa
Javier López Rodríguez	 Centrocampista
Juan Albín	 Delantero
Joan Capdevila	 Defensa
Diego Colotto	 Defensa
Simão Sabrosa	 Centrocampista
Wakaso Mubarak	 Centrocampista
Cristian Gómez García	 Centrocampista
Cristian Alfonso López	 Centrocampista
Víctor Álvarez Delgado	 Defensa
Real Madrid FC
Iker Casillas	 Portero
Raphael Varane	 Defensa
Képler Laveran Lima Ferreira	 Defensa
Sergio Ramos	 Defensa
Fábio Alexandre da Silva Coentrão	 Defensa
Sami Khedira	 Centrocampista
Cristiano Ronaldo	 Delantero
Ricardo Izecson Dos Santos Leite	 Centrocampista
Karim Benzema	 Delantero
Mesut Özil	 Centrocampista
Ricardo Carvalho	 Defensa
Marcelo Vieira Da Silva Junior	 Defensa
Antonio Adán	 Portero
Xabi Alonso	 Centrocampista
Michael Essien	 Centrocampista
Álvaro Arbeloa	 Defensa
Raúl Albiol	 Defensa
Luka Modric	 Centrocampista
Gonzalo Higuaín	 Delantero
José Callejón	 Delantero
Ángel Di María	 Centrocampista
Lassana Diarra	 Centrocampista
José Ignacio Fernández Iglesias	 Defensa
Álvaro Morata	Centrocampista
Atlético de Madrid
Sergio Asenjo	 Portero
Diego Godín	 Defensa
Filipe Luis Kasmirski	 Defensa
Mario Suárez	 Centrocampista
Tiago Cardoso Mendes	 Centrocampista
Jorge Resurrección	 Centrocampista
Adrián López Álvarez	 Delantero
Raúl García Escudero	 Centrocampista
Radamel Falcao García	 Delantero
Arda Turan	 Centrocampista
Cristian Rodríguez	 Centrocampista
Thibaut Courtois	 Portero
Gabriel Fernández Arenas	 Centrocampista
Domingo Cisma	 Defensa
Sílvio Manuel de Azevedo Ferreira Sá Pereira	 Defensa
Daniel Alberto Díaz	 Defensa
Diego Da Silva Costa	 Delantero
Juan Francisco Torres Belén	 Defensa
Emre Belozoglu	 Centrocampista
João Miranda De Souza Filho	 Defensa
Javier Manquillo Gaitán	 Defensa
Óliver Torres Muñoz	 Centrocampista
Abdelkader Ouelasti	 Defensa
Sevilla FC
Andrés Palop	 Portero
Federico Fazio	 Defensa
Fernando Navarro Corbacho	 Defensa
Emir Spahic	 Defensa
Juan Torres Ruiz	 Defensa
José Campaña	 Centrocampista
Jesús Navas	 Centrocampista
Gary Medel	 Centrocampista
Álvaro Negredo	 Delantero
Diego Perotti	 Centrocampista
Ivan Rakitic	 Centrocampista
Hedwiges Maduro	 Defensa
Diego López	 Portero
Manuel Del Moral Fernández	 Delantero
Piotr Trochowski	 Centrocampista
Antonio Luna	 Defensa
Javier Hervás Salmoral	 Centrocampista
José Antonio Reyes	 Centrocampista
Papa Babacar Diawara	 Delantero
Alex Sandro Mendonca dos Santos	 Defensa
Geoffrey Kondogbia	 Centrocampista
Jorge Andújar Moreno	 Defensa
Alberto Botía	 Defensa
Deportivo de La Coruña FC
Daniel Aranzubia	 Portero
Manuel Pablo	 Defensa
Evaldo Fabiano	 Defensa
Alejandro Bergantiños García	 Centrocampista
José Eduardo Rosa Vale Castro	 Defensa
Aythami Artiles Oliva	 Defensa
André Filipe Bernardes Santos	 Centrocampista
Luis Miguel Afonso Fernandes	 Delantero
Juan Domínguez Lamas	 Centrocampista
Iván Sánchez-Rico Soto	 Delantero
Germán Lux	 Portero
Abel Aguilar	 Centrocampista
Laureano Sanabria Ruiz	 Defensa
Bruno Alexandre Vilela Gama	 Centrocampista
Ayoze Díaz Díaz	 Defensa
Javier Camuñas	 Centrocampista
Roderick Jefferson Gonçalves Miranda	 Defensa
Juan Carlos Valerón	 Centrocampista
Diogo Salomao	 Centrocampista
Rodolfo Bodipo	 Delantero
Carlos Marchena	 Defensa
Nélson Miguel Castro Oliveira	 Delantero
Pablo Insúa Blanco	 Defensa
Tiago Miguel Baia Pinto	 Defensa
Real Betis
Casto Espinosa Barriga	 Portero
Francisco Javier Chica Torres	 Defensa
Pedro Mario Álvarez Abrante	 Defensa
Antonio Amaya	 Defensa
José Antonio Dorado Ramírez	 Defensa
Alejandro Martínez Sánchez	 Centrocampista
Ángel Domingo López Ruano	 Defensa
Rubén Pérez Minguez	 Centrocampista
Jonathan Pereira	 Delantero
Beñat Etxebarria Urkiaga	 Centrocampista
Alejandro Pozuelo Melero	 Delantero
Paulao Afonso Santos Junior	 Defensa
Adrián San Miguel del Castillo	 Portero
Salvador Sevilla López	 Centrocampista
Joel Campbell	 Delantero
Damien Perquis	 Defensa
Juan Carlos Pérez López	 Centrocampista
Salvador José Milhazes Agra	 Delantero
Jorge Molina	 Delantero
Emmanuel Nosakhare Igiebor	 Centrocampista
José Alberto Cañas Ruiz Herrera	 Centrocampista
Nelson Augusto Tomar Marcos	 Defensa
Ignacio Pérez Santamaría	 Defensa
Rubén Castro	 Delantero
Fabricio Agosto Ramírez	 Portero
Álvaro Vadillo	 Delantero
José Antonio Delgado Villar	 Centrocampista
Real Sociedad 
Claudio Bravo	 Portero
Carlos Martínez	 Defensa
Mikel González	 Defensa
Gorka Elustondo	 Centrocampista
Markel Bergara	 Centrocampista
Iñigo Martínez Berridi	 Defensa
Antoine Griezmann	 Delantero
Asier Illarramendi	 Centrocampista
Imanol Agirretxe	 Delantero
Xabier Prieto Argarate	 Centrocampista
Carlos Vela	 Delantero
Eñaut Zubikarai	 Portero
Rubén Pardo Gutiérrez	 Centrocampista
Ion Ansotegi	 Defensa
David Zurutuza	 Centrocampista
Gonzalo Castro	 Centrocampista
Liassine Cadamuro	 Defensa
José Ángel Valdés Díaz	 Defensa
Diego Ifrán	 Delantero
Daniel Estrada	 Centrocampista
Javier Ros Añón	 Centrocampista
Alberto De la Bella	 Defensa
Levante
Gustavo Munúa	 Portero
David Navarro	 Defensa
Héctor Rodas	 Defensa
Miguel Pallardó	 Centrocampista
José Javier Barkero Saludes	 Centrocampista
Nabil El Zhar	 Delantero
Ángel Luis Rodríguez Díaz	 Delantero
Vicente Iborra	 Centrocampista
Juan Francisco García García	 Defensa
Dariusz Dudka	 Centrocampista
Nikos Karabelas	 Defensa
Pedro Ríos	 Centrocampista
Theofanis Gekas	 Delantero
Sergio Ballesteros	 Defensa
Pedro López Muñoz	 Defensa
Juan Luis Gómez López	 Centrocampista
Miguel Alfonso Herrero Javaloyas	 Centrocampista
Christian Lell	 Defensa
Papakouly Diop	 Centrocampista
Obafemi Martins	 Delantero
Roger Martí Salvador	 Delantero
Rubén García Santos	 Centrocampista
Mallorca FC	 
Joao Victor Albuquerque Bruno	 Centrocampista
Anderson Conceição Benedito	 Defensa
Tomás Pina	 Centrocampista
Antonio López	 Defensa
Michael Pereira	 Delantero
Emilio Nsue	 Delantero
Giovani dos Santos	 Delantero
Tomer Hemed	 Delantero
Javier Márquez	 Centrocampista
Dudu Aouate	 Portero
Pedro Tunon Geromel	 Defensa
José Carlos Araujo Nunes	 Defensa
Pedro Bigas	 Defensa
Víctor Casadesús Castaño	 Delantero
José Luis Martí Soler	 Centrocampista
Alejandro Alfaro	 Centrocampista
Javier Arizmendi	 Delantero
Kevin García Martínez	 Defensa
Andreu Fontás	 Defensa
Joaquín Navarro Jiménez	 Defensa
Álvaro Giménez Candela	 Delantero
Charlie Took	 Defensa
Marc Fernández Gracia	 Centrocampista
Brandon Thomas Llamas	 Centrocampista
Valencia FC
Diego Alves Carreira	 Portero
Aly Cissokho	 Defensa
Adil Rami	 Defensa
Fernando Gago	 Centrocampista
David Albelda	 Centrocampista
Jonas Gonçalves Oliveira	 Delantero
Sofiane Feghouli	 Centrocampista
Roberto Soldado	 Delantero
Éver Banega	 Centrocampista
Pablo Piatti	 Delantero
João Pedro da Silva Pereira	 Defensa
Vicente Guaita	 Portero
Antonio Barragán	 Defensa
Jonathan Viera Ramos	 Delantero
Nelson Valdez	 Delantero
Andrés Guardado	 Centrocampista
Víctor Ruiz	 Defensa
Ricardo Miguel Moreira da Costa	 Defensa
Daniel Parejo	 Centrocampista
Jeremy Mathieu	 Defensa
Alberto Facundo Costa	 Centrocampista
Juan Bernat	 Centrocampista
Osasuna
Marc Bertrán	 Defensa
Rubén González Rocha	 Defensa
Miguel Flaño	 Defensa
Manuel Jesús Ortiz Toribio	 Defensa
Ion Echaide	 Defensa
Enrique Sola Clemente	 Delantero
Masoud Shojaei	 Centrocampista
Emiliano Armenteros	 Centrocampista
Francisco Puñal	 Centrocampista
Sisinio González Martínez	 Centrocampista
Joseba Llorente	 Delantero
Andrés Fernández	 Portero
Alejandro Arribas	 Defensa
Oier Sanjurjo Maté	 Defensa
Álvaro Cejudo	 Centrocampista
Juan Francisco Martínez Modesto	 Delantero
Manuel Omwu	 Delantero
Fernando Macedo Da Silva	 Centrocampista
Roland Lamah	 Centrocampista
Roberto Torres	 Centrocampista
David Timor	 Centrocampista
Raoul Loe	 Centrocampista
Damiá Abella Pérez	 Defensa
Anthony Annan	 Centrocampista
Celta de Vigo
Sergio Álvarez Conde	 Portero
Hugo Mallo Novegil	 Defensa
Roberto Lago	 Defensa
Borja Oubiña	 Centrocampista
Andrés Túñez	 Defensa
Jonathan Vila Pereira	 Centrocampista
Alejandro López Sánchez	 Centrocampista
Mario Bermejo	 Delantero
Iago Aspas	 Delantero
Gustavo Cabral	 Defensa
Javier Varas	 Portero
Cristian Bustos	 Centrocampista
Carlos Bellvis	 Defensa
Joan Tomás Campasol	 Centrocampista
Park Chu-Young	 Delantero
Antonio Rodríguez Dovale	 Delantero
Samuel Llorca Ripoll	 Defensa
Enrique De Lucas	 Delantero
Michael Krohn-Dehli	 Centrocampista
Augusto Fernández	 Centrocampista
Ignacio Insa Bohigues	 Centrocampista
Jonathan Castro Otto	 Defensa
Rayo Vallecano
Rubén Martínez	 Portero
Roberto Román Triguero	 Defensa
José Casado	 Defensa
Mikel Labaka	 Defensa
Alejandro Gálvez	 Defensa
Sergio Rodríguez	 Defensa
Manuel Arana	 Centrocampista
Adrián González Morales	 Centrocampista
José Carlos Fernández Vázquez	 Centrocampista
Francisco Medina Luna	 Delantero
Alejandro Domínguez	 Delantero
Daniel Giménez Hernández	 Portero
Nickie Bille Nielsen	 Delantero
Jordi Amat	 Defensa
Roberto Trashorras	 Centrocampista
Javi Fuego	 Centrocampista
Alhassane Bangoura	 Delantero
Franco Vázquez	 Centrocampista
Mohammed Abu	 Centrocampista
Andrija Delibasic	 Delantero
David Cobeño	 Portero
Leonardo Carrilho Baptistao	 Delantero
Rubén Ramiro Pastor	 Delantero
José Ignacio Martínez García	 Defensa
Valladolid FC
Jaime Jiménez Merlo	 Portero
Antonio Rukavina	 Defensa
Marc Valiente	 Defensa
Henrique Sereno	 Defensa
Jesús Rueda	 Defensa
Juan Ángel Neira	 Delantero
Javier Baraja	 Defensa
Javier Guerra Rodríguez	 Delantero
Óscar Javier González Marcos	 Centrocampista
Daniel Larsson	 Delantero
Daniel Hernández Santos	 Portero
Julián Omar Ramos Suárez	 Centrocampista
Alberto Bueno	 Delantero
Lluis Sastre Reus	 Centrocampista
Carlos Peña	 Defensa
Álvaro Rubio	 Centrocampista
Patrick Ebert	 Centrocampista
Víctor Pérez Alonso	 Centrocampista
Mikel Balenziaga	 Defensa
Mateus Alberto Contreiras Gonçalves	 Delantero
Manuel Coronado Plá	 Delantero
Rubén Peña Jiménez	 Centrocampista
Granada FC
Antonio Rodríguez Martínez	 Portero
Allan-Roméo Nyom	 Defensa
Yacine Brahimi	 Centrocampista
Diego Mainz	 Defensa
Guillherme Siqueira	 Defensa
Antonio Floro Flores	 Delantero
Iñigo López	 Defensa
Youssef El-Arabi	 Delantero
Jaime Romero	 Centrocampista
Daniel González Benítez	 Centrocampista
Darwin Machís	 Delantero
Roberto Fernández Alvalleros	 Portero
Mikel Rico Moreno	 Centrocampista
Pape Malickou Diakhaté	 Defensa
Brayan Alexis Angulo	 Defensa
Hassan Yebda	 Centrocampista
Manuel Lucena	 Defensa
Fabián Orellana	 Delantero
Borja Gomez	 Defensa
Juan Manuel Ortiz Palazón	 Defensa
Gabriel Torje	 Delantero
Moisés Hurtado	 Centrocampista
Iriney Santos Da Silva	 Centrocampista
Odion Ighalo	 Delantero
Zaragoza FC
Roberto Jiménez Gago	 Portero
José María Movilla	 Centrocampista
Javier Paredes	 Defensa
Álvaro González Soberón	 Defensa
Raúl Goni	 Defensa
Carlos Reina Aranda	 Delantero
Eduardo Oriol	 Delantero
Helder Postiga	 Delantero
Antonio Galdeano Benítez	 Centrocampista
Francisco Montañés	 Centrocampista
Christian Koffi Ndri Romaric	 Centrocampista
José María Martín-Bejarano Serrano	 Centrocampista
Glenn Loovens	 Defensa
Stefan Babovic	 Centrocampista
Lucas Wilchez	 Centrocampista
Cristian Sapunaru	 Defensa
Franco Zuculini	 Centrocampista
Abraham Minero Fernández	 Defensa
Adam Pintér	 Defensa
Javier Álamo Cruz	 Delantero
Ivan Obradovic	 Defensa
Jorge Ortí Gracia	 Delantero
Víctor Rodríguez Romero	 Delantero
Malaga FC
Jesús Gámez	 Defensa
Weligton Robson Pena de Oliveira	 Defensa
Martín Demichelis	 Defensa
Ignacio Camacho	 Centrocampista
Joaquín Sánchez Rodríguez	 Centrocampista
Jérémy Toulalan	 Centrocampista
Javier Saviola	 Delantero
Sebastián Fernández	 Delantero
Wilfredo Caballero	 Portero
Nacho Monreal	 Defensa
Manuel Iturra	 Centrocampista
Sergio Paulo Barbosa Valente	 Centrocampista
Eliseu Pereira Dos Santos	 Centrocampista
Francisco Portillo Soler	 Delantero
Diego Buonanotte	 Centrocampista
Sergio Sánchez	 Defensa
Francisco Román Alarcón Suárez	 Delantero
Oguchi Onyewu	 Defensa
Roque Santa Cruz	 Delantero
Juan Miguel Jiménez López	 Delantero
José Luis García del Pozo	 Centrocampista
Fabrice Olinga Essono	 Delantero
Getafe FC
Miguel Ángel Moyá	 Portero
Alexis Ruano Delgado	 Defensa
José Manuel Jiménez Ortiz	 Defensa
Miguel Torres	 Defensa
Mehdi Lacen	 Centrocampista
Alberto Lopo	 Defensa
Álvaro Vázquez García	 Delantero
Nicolás Ladislao Fedor Flores	 Delantero
Pablo Sarabia	 Centrocampista
Jaime Gavilán	 Centrocampista
Adrián Colunga	 Delantero
Pedro León Sánchez Gil	 Centrocampista
Rafael López Gómez	 Defensa
David Ángel Abraham	 Defensa
Diego Castro	 Centrocampista
Ángel Lafita	 Centrocampista
Abdel Barrada	 Centrocampista
Juan Valera	 Defensa
Miguel Marcos Madera	 Centrocampista
Juan Rodríguez Villamuela	 Centrocampista
Borja Fernández Fernández	 Centrocampista
Xavier Torres	 Centrocampista
Francisco Alcácer García	 Delantero
